11111111111
1E0C0P0C0E1
11111111111