11111111111
1P0C0E0C0P1
11111111111