11111111111111111
10001000010000001
10P01C1001C100E01
10000010000100001
11111111111111111