11111111111111111
10001T0001T000001
10P01C1001C100E01
10000T1000T100001
11111111111111111