11111111111111111
1P0000011100000E1
11111101C10111111
10000001010000001
10111101010111101
100CC0010100CC001
10111111011111101
1C000000C000000C1
11111111111111111