11111111111111111
1P0000011100000E1
11111101C10111111
10000001T10000001
10111101T10111101
10TCCT01T10TCCT01
10111111T11111101
1CTTT0TTCTT0TTTC1
11111111111111111