11111111111111111
100C1010P0101C001
10111010101011101
1T1CT000T000TC1T1
100T000TET000T001
1T1CT000T000TC1T1
10111010101011101
100C101000101C001
11111111111111111