11111111111111111
100C1010P0101C001
10111010101011101
101C000000000C101
10000000E00000001
101C000000000C101
10111010101011101
100C101000101C001
11111111111111111