11111111111111111
1001T1001001T1001
100TCT00100TCT001
1001T1001001T1001
10P00000000000E01
1001T1001001T1001
100TCT00100TCT001
1001T1001001T1001
11111111111111111