11111111111111111111111
10000P0000E00000000C001
11111111111111111111111