1111111111111111111111111111111111
1PTTTTTTTTTTTTTTTCTTTTTTTTTTTTTTE1
1111111111111111111111111111111111