1111111111111
1000100010001
10P010C010E01
1000100010001
1111111111111