100000000000000001
100000000000C00001
11111111P111111111
100000000000E00001
111111111111111111