000000000000000000
000000000000C00000
01111111P111111110
000000000000E00000
000000000000000000