111111111111111111
000000000000C00001
01111111P111111111
000000000000E00001
111111111111111111