111111111111111111
100000000000C00000
11111111P111111110
100000000000E00000
100000000000000001