111111111111111111
1qwerty!@#$%^&*()1
111111111111111111
